antoine_brutus_menier	religion	roman_catholic_church
denys_rayner	cause_of_death	cancer
nietzchka_keene	place_of_death	madison
friedrich_bessel	profession	mathematician
thomas_harrison_1740	profession	engineer
richard_brautigan	profession	novelist
anthony_asquith	location	london
robert_noyce	profession	physicist
ignaz_franz_castelli	profession	dramatist
russell_bufalino	gender	male
mary_de_bohun	nationality	kingdom_of_england
cato_maximilian_guldberg	place_of_death	oslo
gerbrand_adriaensz_bredero	location	amsterdam
jefferson_davis	profession	politician
william_henry_phelps	place_of_death	caracas
roger_atkinson_pryor	nationality	united_states
nobuko_otowa	profession	actor
st_clair_drake	profession	sociologist
tommy_tedesco	nationality	united_states
giovanni_battista_morgagni	profession	anatomist
otto_lilienthal	cause_of_death	airplane_crash
snooky_pryor	place_of_death	cape_girardeau
jiang_tingxi	profession	painter
hans_dreier	location	hollywood
dru_sjodin	location	grand_forks
goto_shimpei	nationality	japan
philip_h_lathrop	profession	cinematographer
antonio_cornejo_polar	nationality	peru
adele_jergens	place_of_birth	brooklyn
jimmie_davis	location	louisiana
joseph_h_bottum	nationality	united_states
miguel_cabrera_1695	location	oaxaca
rajiv_gandhi	cause_of_death	assassination
harrison_gray_otis_1765	nationality	united_states
peter_scheemakers	nationality	united_kingdom
henrich_focke	place_of_death	bremen
charles_henry_driver	nationality	england
francis_biddle	institution	harvard_university
yongzheng_emperor	children	qianlong_emperor
thomas_wentworth_higginson	place_of_birth	cambridge_massachusetts
john_hannah_gordon	profession	judge
william_whewell	profession	scientist
charles_berny_douville	nationality	france
ambrogio_bergognone	nationality	italy
walt_whitman	religion	unitarian_universalism
wallace_pratt	gender	male
rene_clair	gender	male
carl_edvard_rotwitt	profession	politician
friedrich_burklein	nationality	germany
franz_josef_strauss	place_of_death	regensburg
bernard_coleridge_2nd_baron_coleridge	institution	eton_college
joachim_wtewael	nationality	netherlands
anna_e_roosevelt	parents	eleanor_roosevelt
thomas_quellinus	location	copenhagen
louis_couty	nationality	france
gilbert_roland	profession	actor
nikola_vitov_gucetic	gender	male
gil_vicente	nationality	portugal
ralph_engelstad	location	minnesota
arthur_jeffrey_dempster	nationality	united_states
joseph_pinzolo	cause_of_death	murder
mikael_nalbandian	nationality	armenia
thomas_wakefield_blackburn_ii	profession	lyricist
leon_w_johnson	institution	california_institute_of_technology
francois_vincent_raspail	nationality	france
joachim_ernst_von_grumbkow	location	pomerania
dalrymple_maitland	location	liverpool
imagawa_yoshimoto	gender	male
hungry_joe	nationality	united_states
william_gaston_1820	institution	brown_university
amos_w_barber	profession	physician
john_d_new	nationality	united_states
edwin_bud_shrake	profession	screenwriter
jean_pierre_minckelers	place_of_birth	maastricht
annette_richardson_dinwoodey	gender	female
ismail_merchant	nationality	united_kingdom
rene_viviani	gender	male
lucebert	nationality	netherlands
mohammed_daoud_khan	place_of_birth	kabul
alan_king	place_of_birth	new_york
joseph_carlebach	religion	judaism
alexander_brullov	location	saint_petersburg
walter_annenberg	location	long_island
howard_martin_temin	profession	scientist
adolf_loos	nationality	austria
nathan_hale	gender	male
alfred_zwiebel	gender	male
rigas_feraios	cause_of_death	assassination
francis_bacon_1909	location	dublin
robert_worth_bingham	location	london
gustavus_adolphus_henry_sr	gender	male
alfred_wilkinson_johnson	place_of_birth	philadelphia
ivo_caprino	gender	male
hans-georg_gadamer	place_of_birth	marburg
kim_philby	place_of_death	moscow
martin_hengel	gender	male
ethel_lilian_voynich	parents	george_boole
marjorie_merriweather_post	spouse	joseph_e_davies
ernst_wilhelm_nay	gender	male
nathan_marcus_adler	ethnicity	germans
david_greenaway_1889	gender	male
titus_de_bobula	place_of_birth	budapest
bernard_berenson	profession	writer
silas_c_swallow	location	harrisburg
ayn_rand	religion	judaism
donald_simpson_bell	place_of_birth	harrogate
philipp_lenard	location	bratislava
wladyslaw_zelenski	profession	organist
helen_vinson	nationality	united_states
marshall_mcluhan	profession	educator
edouard_vaillant	place_of_death	saint_mande
salem_poor	nationality	united_states
james_kewley_ward	nationality	canada
lemuel_p_grant	location	atlanta
johanna_of_bavaria_queen_of_bohemia	gender	female
leo_brewer	place_of_death	lafayette_california
ashley_day_leavitt	gender	male
nicholas_vansittart_1st_baron_bexley	place_of_birth	bloomsbury_london
william_winterbotham	location	london
prince_sigismund_of_prussia_kiel	parents	princess_irene_of_hesse_and_by_rhine
horst_wessel	gender	male
johann_von_lowenstern_kunckel	nationality	germany
elisha_p_ferry	nationality	united_states
angel_juarbe_jr	cause_of_death	murder
giovanni_battista_sammartini	gender	male
robert_simson	nationality	united_kingdom
frank_rosenfelt	place_of_death	los_angeles
matthew_shepard	location	casper
james_william_mcghee	location	colorado
alan_dargin	ethnicity	indigenous_australians
heinrich_mann	place_of_death	santa_monica_california
gobind_singh	gender	male
big_pun	location	the_bronx
lev_arnshtam	gender	male
robert_smithson	nationality	united_states
richard_monckton_milnes_1st_baron_houghton	nationality	united_kingdom
angelo_agostini	profession	cartoonist
franca_marzi	nationality	italy
jose_rodrigues	place_of_death	lisbon
william_cowper_brann	cause_of_death	firearm
gilbert_parker	profession	politician
john_whiting	nationality	england
frank_osmond_carr	nationality	england
jagdish_chandra_jain	cause_of_death	myocardial_infarction
leopold_ii_holy_roman_emperor	children	archduke_joseph_of_austria_palatine_of_hungary
matthew_deady	gender	male
cipriano_de_rore	place_of_death	parma
branko_mikulic	profession	politician
herschel_bernardi	profession	actor
peter_i_of_yugoslavia	gender	male
oneil_ford	nationality	united_states
hermann_jakob_knapp	institution	utrecht_university
frank_chapman	gender	male
david_humphreys_1752	gender	male
john_bell_1765	place_of_birth	londonderry_new_hampshire
basil_spence	gender	male
zutsu_manemon	nationality	japan
thomas_w_sherman	place_of_birth	newport_rhode_island
hashimoto_hakaru	cause_of_death	typhoid_fever
pierre_bayle	nationality	france
voltaire	location	paris
jacob_stout	place_of_death	kent_county
alexander_i_of_scotland	place_of_death	stirling
manuel_a_alonso	profession	writer
erik_bryggman	location	turku
peter_paul_rubens	location	antwerp
irina_godunova	spouse	feodor_i_of_russia
simeon_gannett_reed	gender	male
john_k_shields	gender	male
edward_overton_jr	place_of_birth	towanda
richard_nelson_gale	gender	male
john_a_j_creswell	location	elkton
amun-her-khepeshef	parents	nefertari
louis_michel_thibault	nationality	france
stephen_h_weed	nationality	united_states
gomez_davila	profession	writer
pope_hilarius	religion	catholicism
rene_edward_de_russy	profession	engineer
edmond_noel	religion	baptist
warren_oates	cause_of_death	myocardial_infarction
frederick_william_burbidge	gender	male
benjamin_fondane	institution	university_of_iasi
henry_coward	institution	university_of_oxford
frank_coghlan_jr	nationality	united_states
james_s_jackson	place_of_death	boyle_county
conor_cruise_obrien	place_of_death	howth
ronald_george_wreyford_norrish	nationality	united_kingdom
paul_georg_von_mollendorff	nationality	germany
marilyn_buferd	cause_of_death	pancreatic_cancer
jeremiah_jenks	nationality	united_states
jose_maria_eca_de_queiroz	place_of_birth	povoa_de_varzim
ferdinand_ii_of_castile	spouse	oneca_daughter_of_sancho_i_of_pamplona
john_of_gaunt_1st_duke_of_lancaster	children	philippa_of_lancaster
hugo_sinzheimer	place_of_birth	worms
jerome_robbins	place_of_birth	new_york
thomas_gold	institution	trinity_college_cambridge
lewis_bagot	institution	westminster_school
frederick_augustus_smith	nationality	united_kingdom
johnny_arthur	place_of_death	woodland_hills
irving_kaplansky	profession	mathematician
juan_david_garcia_bacca	profession	philosopher
bertha_krupp	location	essen
jack_onslow	location	pennsylvania
romy_schneider	religion	catholicism
yoshida_kenichi	gender	male
jane_wyatt	institution	barnard_college
prince_eugen_duke_of_narke	place_of_birth	drottningholm_palace
eddie_bracken	profession	actor
yokoi_shounan	cause_of_death	assassination
desire_girouard	gender	male
rory_storm	location	liverpool
francis_atterbury	institution	westminster_school
dori_seda	gender	female
frank_swettenham	gender	male
julius_leopold_pagel	profession	physician
robert_mallory	gender	male
yone_noguchi	nationality	japan
johann_michael_moscherosch	gender	male
francis_t_maloney	place_of_birth	meriden
howell_edmunds_jackson	cause_of_death	tuberculosis
lorenzo_storioni	place_of_death	cremona
andres_bonifacio	cause_of_death	firearm
james_c_corman	profession	politician
hugh_cairns_1st_earl_cairns	place_of_death	bournemouth
isaac_asimov	profession	science_writer
count_richard_von_bienerth_schmerling	nationality	austria
john_l_balderston	profession	journalist
albert_sleeper	religion	episcopal_church_in_the_united_states_of_america
warren_t_mccray	gender	male
luis_marquina	profession	screenwriter
fernando_caldeiro	location	buenos_aires
aziz_suryal_atiya	institution	cairo_university
eppie_friedman	gender	female
richard_pistol_allen	profession	drummer
maurice_perrault	nationality	canada
johann_georg_bergmuller	nationality	germany
oskar_dinort	place_of_death	cologne
jack_daniel	location	tennessee
samuel_b_fuller	profession	businessperson
sebastian_leitner	nationality	germany
maksymilian_berezowski	place_of_death	warsaw
mark_of_ephesus	gender	male
gottfried_osann	place_of_death	wurzburg
maria_luisa_of_savoy	spouse	philip_v_of_spain
etienne_pierre_ventenat	place_of_birth	limoges
nicholas_heath	nationality	england
princess_viktoria_luise_of_prussia	place_of_birth	potsdam
a_p_de_candolle	gender	male
mark_oliphant	nationality	australia
roger_sherman_baldwin	place_of_birth	new_haven
frank_gotch	nationality	united_states
david_sarnoff	place_of_death	new_york
maria_teresa_de_noronha	gender	female
isabelle_caubere	place_of_death	paris
ben_westlund	religion	episcopal_church_in_the_united_states_of_america
vijay_r_singh	gender	male
edward_felix_baxter	gender	male
andrey_bolotov	nationality	russia
elsa_triolet	nationality	france
francois_de_bourbon_prince_de_conti	place_of_birth	la_ferte_sous_jouarre
james_c_corman	gender	male
lorrin_andrews	gender	male
philipp_krementz	gender	male
septimius_severus	profession	roman_emperor
paddy_hannan	location	western_australia
thomas_jaggar	profession	geologist
charles_i_of_england	children	princess_elizabeth_of_england
jacob_riis	profession	journalist
johnny_thunders	place_of_death	new_orleans
richard_willstatter	location	germany
vuk_stefanovic_karadzic	place_of_death	vienna
edward_troye	gender	male
bert_h_miller	profession	attorney_at_law
emile-justin_menier	profession	politician
manuel_puig	place_of_death	cuernavaca
anthony_eden	gender	male
bertholet_flemalle	place_of_death	liege
edmond_hogan	religion	catholic
sylvia_schur	location	chicago
gregor_strasser	nationality	germany
henry_thrale	institution	university_college_oxford
gustaf_lindblom	nationality	sweden
janio_quadros	place_of_death	sao_paulo
claudia_muzio	place_of_death	rome
otho_r_singleton	nationality	united_states
glenni_william_scofield	profession	lawyer
arthur_amos_noyes	institution	massachusetts_institute_of_technology
elizabeth_bibesco	nationality	united_kingdom
eric_von_schmidt	place_of_death	fairfield
alexander_mcdonald	location	williamsport
princess_maria_teresa_of_bourbon_two_sicilies	place_of_death	cannes
teddy_kollek	gender	male
ted_theodore	place_of_birth	adelaide
stefan_mazurkiewicz	place_of_death	grodzisk_mazowiecki
frederick_j_osterling	location	pittsburgh
peter_tosh	cause_of_death	firearm
julio_herrera_y_reissig	gender	male
henry_hobson_richardson	profession	architect
joe_hill	location	portland
alfredo_de_sa_cardoso	profession	officer
venceslaus_ii_of_bohemia	gender	male
john_f_dryden	gender	male
carl_stamitz	place_of_birth	mannheim
roy_boehm	nationality	united_states
john_dollond	nationality	united_kingdom
walter_spence	nationality	canada
ticky_holgado	profession	actor
dorothea_lange	gender	female
samuel_cahen	nationality	france
harriet_taylor_upton	nationality	united_states
pierre_dupont_de_letang	gender	male
carlos_maria_de_alvear	children	torcuato_de_alvear
alma_bridwell_white	location	kentucky
georges_darmagnac	profession	diplomat
wager_swayne	place_of_birth	columbus_ohio
thomas_gregson	place_of_birth	durham
madelyn_clare	nationality	united_states
kenneth_grahame	gender	male
william_le_baron_jenney	nationality	united_states
thelma_furness_viscountess_furness	nationality	united_kingdom
john_elector_of_saxony	location	saxony
tetsuo_ochikubo	nationality	united_states
enguerrand_iii_lord_of_coucy	location	picardie
rich_mullins	profession	singer
stanford_e_parris	profession	lawyer
curly_lambeau	gender	male
caspar_isenkrahe	profession	physicist
camille_saint-saens	place_of_death	algiers
elena_mukhina	gender	female
mariana_victoria_of_spain	spouse	joseph_i_of_portugal
elizabeth_f_ellet	nationality	united_states
bob_purkey	nationality	united_states
anna_of_bohemia	parents	constance_of_hungary
polly_ann_young	cause_of_death	cancer
gove_saulsbury	place_of_death	dover_delaware
rene_de_longueil	profession	politician
sarah_parker_remond	ethnicity	african_american
kawamura_kageaki	place_of_birth	kagoshima
ludwig_august_ritter_von_benedek	place_of_birth	sopron
william_buckley	gender	male
ol_dirty_bastard	place_of_birth	brooklyn
hashim_al-atassi	gender	male
nazli_sabri	children	farouk_of_egypt
pope_felix_i	religion	catholicism
gerard_victory	profession	composer
juba_ii	spouse	cleopatra_selene
ramon_borrell_count_of_barcelona	nationality	spain
mrs_elmer_j_mcatee	cause_of_death	airplane_crash
constantin_fahlberg	place_of_death	nassau_germany
matty_hull	place_of_death	basra
raffaele_stern	location	rome
katherine_dunham	gender	female
margot_asquith	nationality	united_kingdom
c_w_alcock	nationality	england
katherine_carl	nationality	united_states
jeanne_dalcy	gender	female
ji_i_t_anovsky	place_of_birth	cieszyn
art_blakey	ethnicity	african_american
freake	location	london
louis_ix_of_france	children	philip_iii_of_france
samuel_freeman_miller	place_of_birth	richmond_kentucky
vasko_popa	profession	poet
john_romilly_1st_baron_romilly	place_of_birth	london
johann_albrecht_bengel	place_of_death	stuttgart
marinus_willett	gender	male
kannadasan	nationality	india
lindley_m_garrison	profession	lawyer
gustavus_adolphus_of_sweden	children	christina_of_sweden
john_butler_yeats	gender	male
richard_saltonstall_greenough	profession	artist
mehdi_akhavan-sales	location	mashhad
ebe_w_tunnell	gender	male
herbert_kitchener_1st_earl_kitchener	profession	engineer
heinrich_schweiger	nationality	austria
giuseppe_sergi	nationality	italy
philippe_etancelin	profession	racecar_driver
carlo_goldoni	nationality	republic_of_venice
sidney_myer	gender	male
norman_z_mcleod	profession	film_director
richard_dimbleby	place_of_death	st_thomas_hospital
julius_hawley_seelye	place_of_birth	bethel_connecticut
albert_fink	profession	engineer
l_s_lowry	gender	male
johannes_joachim_degenhardt	nationality	germany
techichpotzin	parents	moctezuma_ii
stewart_farrar	religion	paganism
george_fisher_baker	nationality	united_states
vosough_od-dowleh	religion	shia_islam
margaret_fell	location	dalton-in-furness
masayoshi_ohira	place_of_death	tokyo
andre_raponda_walker	gender	male
christine_pascal	profession	screenwriter
rudolf_otto	profession	philosopher
lucy_parsons	nationality	united_states
limberakis_gerakaris	place_of_death	brescia
william_cannon	place_of_birth	bridgeville
powell_clayton	gender	male
albert_van_coile	place_of_birth	bruges
mitchell_kennerley	profession	writer
heinrich_smidt	place_of_death	berlin
vergilius_of_salzburg	place_of_death	salzburg
francois_chauveau	place_of_birth	paris
calbraith_perry_rodgers	nationality	united_states
johann_nepomuk_geiger	gender	male
samora_machel	religion	atheism
matthew_crooks_cameron	nationality	canada
amadeo_bordiga	profession	journalist
claud_schuster_1st_baron_schuster	place_of_death	charing_cross_hospital
william_j_florence	profession	songwriter
william_appleton	profession	banker
george_dewitt	profession	singer
maurice_prendergast	place_of_death	new_york
alfred_b_mullett	place_of_death	washington_united_states
eudoxia_streshneva	place_of_death	moscow
jean_gabin	nationality	france
robert_hofstadter	gender	male
rene_descartes	place_of_death	stockholm
manuel_ruiz_zorrilla	gender	male
james_hazen_hyde	gender	male
simon_fraser_1729	gender	male
anne_marie_martinozzi	children	louis_armand_i_prince_of_conti
daryl_duke	gender	male
sydney_jacobson_baron_jacobson	nationality	south_africa
minnie_devereaux	profession	actor
father_buu_dong	cause_of_death	murder
georg_donner	place_of_death	vienna
jozsef_szlavy	place_of_birth	gyor
alfred_lion	nationality	germany
magdalena_dobromila_rettigova	place_of_death	litomysl
juan_de_pareja	gender	male
vsevolod_meyerhold	gender	male
amalia_rodrigues	gender	female
eduard_von_bauernfeld	nationality	austria
francisco_de_almeida	nationality	portugal
jerome_robbins	gender	male
frederick_william_von_erdmannsdorff	profession	architect
erica_blasberg	profession	golfer
gustave_trouve	place_of_death	paris
william_henry_bragg	religion	christian
maria_alexandrovna_of_hesse	children	grand_duke_nicholas_alexandrovich_of_russia
alexandrina_maria_da_costa	nationality	portugal
peter_arundell	nationality	united_kingdom
abraham_sinkov	place_of_birth	philadelphia
hendrik_van_rijgersma	gender	male
kenneth_mason	gender	male
geremi_gonzalez	location	maracaibo
orville_e_babcock	location	vermont
robert_mackay	gender	male
toyo_miyatake	nationality	united_states
eddie_latheron	gender	male
david_alexander_gordon	nationality	canada
karel_thole	location	north_holland
barnas_sears	place_of_death	saratoga_new_york
alvin_olin_king	location	lake_charles
nagai_naoyuki	place_of_birth	mikawa_province
henri_nestle	place_of_birth	frankfurt
noah_porter	gender	male
william_wyler	nationality	france
bud_abbott	location	asbury_park
p_a_o_siochain	gender	male
joseph_d_nelson	gender	male
schinderhannes	gender	male
max_tishler	institution	harvard_university
archibald_hill	institution	trinity_college_cambridge
eden_natan-zada	nationality	israel
abe_landau	cause_of_death	firearm
dominik_mikolaj_radziwill	gender	male
charles_townshend	spouse	caroline_townshend_1st_baroness_greenwich
william_lee	gender	male
carl_schlechter	place_of_death	budapest
robert_novak	location	joliet
miguel_angel_de_quevedo	profession	architect
rudy_ray_moore	gender	male
isidor_straus	nationality	germany
jared_w_williams	profession	lawyer
charles_trick_currelly	place_of_birth	exeter_ontario
sir_william_johnson_1st_baronet	gender	male
sam_pollard	gender	male
johann_christoph_glaubitz	gender	male
caspar_de_crayer	place_of_death	ghent
artur_bodanzky	place_of_birth	vienna
james_albert_manning_aikins	place_of_death	winnipeg
georg_rudolf_weckherlin	place_of_birth	stuttgart
jim_cantalupo	place_of_death	orlando
frederick_mccoy	place_of_death	melbourne_australia
marcus_elieser_bloch	nationality	germany
henry_wilson_temple	location	pennsylvania
hans_hermann_groer	nationality	austria
james_irwin	profession	astronaut
edward_warner	place_of_death	ypres
richard_vernon	place_of_birth	reading
edward_howard_1877	location	portland
ernst_busch	place_of_birth	essen
friedrich_zelnik	spouse	lya_mara
nancy_kulp	place_of_birth	harrisburg
pope_paul_v	gender	male
simon_channing_williams	place_of_birth	maidenhead
agnes_ayres	place_of_birth	carbondale
thomas_de_buittle	institution	university_of_oxford
mohar_singh_rathore	profession	social_activist
ludvig_mathias_lindeman	place_of_death	oslo
jerome	profession	writer
sigeberht_of_east_anglia	gender	male
franz_antel	place_of_death	vienna
helmuth_hubener	profession	writer
henry_morgan_1819	location	montreal
arnold_escher_von_der_linth	profession	geologist
alexander_berkman	profession	journalist
charles_h_roan	place_of_birth	texas
ayya_khema	ethnicity	germans
gottfried_osann	profession	chemist
paulette_goddard	location	queens
robert_barr	location	glasgow
count_erich_kielmansegg	nationality	austria
rufus_choate	nationality	united_states
giacomo_puccini	place_of_death	brussels
charles_lane_1905	place_of_death	santa_monica_california
hugh_a_drum	gender	male
joy_shelton	place_of_birth	london
marie_lacoste_gerin_lajoie	gender	female
john_brophy	nationality	united_states
martin_van_buren	gender	male
frank_joseph_mcnulty	gender	male
theodor_herzl	ethnicity	hungarian_people
frank_ertel_carlyle	location	north_carolina
stepan_shahumyan	gender	male
gottfried_leibniz	nationality	germany
mo_teh_hui	profession	politician
jack_mercer	place_of_birth	new_york
charles_i_duke_of_brunswick_luneburg	place_of_death	braunschweig
colin_thiele	place_of_death	brisbane
james_anthony_murphy	nationality	united_states
michal_kazimierz_radziwill	place_of_death	bologna
francis_edward_james_keith	institution	university_of_paris
rudi_carrell	location	alkmaar
henry_kimball_hadley	place_of_birth	somerville
nikita_lazarev	gender	male
sophie_of_pomerania	nationality	germany
ahmad_suradji	cause_of_death	capital_punishment
william_rutherford_mead	gender	male
charles_ernest_beule	cause_of_death	suicide
william_of_wykeham	profession	architect
mary_c_seward	religion	congregational_church
b_a_santamaria	gender	male
james_bryant_conant	gender	male
derek_nimmo	location	liverpool
constantia_of_sicily	place_of_birth	sicily
richard_francis_burton	place_of_birth	torquay
jacopo_peri	location	rome
alfred_edward_durrant	gender	male
rambertino_buvalelli	nationality	italy
manuel_vicente_maza	location	buenos_aires
louis_wolheim	nationality	united_states
karl_radek	nationality	austria
bear_bryant	gender	male
michel_corrette	nationality	france
joan_lowery_nixon	place_of_death	houston
alexis_loret	profession	actor
francisco_gonzalo_marin	place_of_death	cuba
atle_selberg	gender	male
jack_walker	gender	male
eugen_fischer	place_of_death	freiburg
helen_hunt_jackson	place_of_birth	amherst
carroll_bond	nationality	united_states
gheorghe_mironescu	place_of_birth	vaslui
manuel_rojas_buenos_aires	profession	writer
ibrahim_kaypakkaya	gender	male
john_f_kennedy	institution	riverdale_country_school
karen_sparck_jones	gender	female
william_freeman_vilas	gender	male
robert_armstrong_1890	place_of_birth	saginaw
earl_l_brewer	place_of_death	jackson
charles_r_bardeen	location	kalamazoo_michigan
tomas_cardinal_o_fiaich	religion	roman_catholic_church
danny_kaye	cause_of_death	myocardial_infarction
jackie_wilson	place_of_death	mount_holly
john_cook_1825	location	illinois
werner_heisenberg	nationality	germany
james_albert_manning_aikins	institution	university_of_toronto
ben_holladay	gender	male
eric_wallace	religion	roman_catholic_church
doc_white	profession	baseball_player
arturo_frondizi	gender	male
milton_friedman	profession	writer
ennio_de_concini	place_of_death	rome
thomas_joannes_stieltjes	place_of_death	toulouse
hobart_baumann_amstutz	institution	garrett-evangelical_theological_seminary
joseph_w_mcclurg	place_of_birth	st_louis_missouri
isaac_newton_van_nuys	place_of_death	los_angeles
ernest_joyce	nationality	england
walter_besant	institution	kings_college_london
etienne_francois_letourneur	place_of_death	laken
gottfried_leibniz	profession	scientist
tadamichi_kuribayashi	location	nagano_prefecture
seba_smith	nationality	united_states
frank_macfarlane_burnet	place_of_death	port_fairy
francois_michel_le_tellier_marquis_de_louvois	place_of_birth	paris
leo_geyr_von_schweppenburg	place_of_birth	potsdam
charles_louis_frederick_duke_of_mecklenburg_mirow	place_of_birth	neustrelitz
alexandra_pavlovna_of_russia	place_of_death	vienna
thomas_h_paynter	nationality	united_states
luigi_nono	place_of_death	venice
max_linder	gender	male
william_king_sebastian	place_of_death	memphis_tennessee
edmonia_lewis	ethnicity	indigenous_peoples_of_the_americas
otto_scherzer	place_of_birth	passau
freda_wright-sorce	location	maryland
rosso_fiorentino	location	florence
john_cardinal_oconnor	nationality	united_states
hedvig_charlotta_nordenflycht	gender	female
antoni_gaudi	place_of_death	barcelona
adolph_frank	profession	chemist
solomon_kullback	gender	male
paisius_of_hilendar	ethnicity	bulgarians
prince_maximilian_margrave_of_baden	parents	prince_berthold_margrave_of_baden
milo_obrenovic_i_prince_of_serbia	place_of_death	belgrade
lafayette_c_baker	nationality	united_states
augusta_holmes	place_of_death	paris
stephen_william_clark	gender	male
alfonso_de_castro	place_of_birth	zamora_spain
andrea_cesalpino	place_of_death	rome
willis_benson_machen	place_of_death	hopkinsville
e_l_m_burns	place_of_birth	ottawa
charles_m_dale	profession	mayor
elizabeth_van_lew	nationality	united_states
edgar_cowan	place_of_birth	westmoreland_county
anders_johan_von_hopken	place_of_death	stockholm
friedrich_grillo	nationality	germany
donald_pederson	location	united_states
emory_s_land	location	colorado
lee_shubert	gender	male
henri_de_gondi	gender	male
conrad_hilton	profession	hotel_manager
rachel_1821	place_of_death	le_cannet
wilhelm_biltz	place_of_death	heidelberg
yitzhak_rabin	profession	prime_minister_of_israel
max_friz	profession	aerospace_engineer
trofim_lysenko	place_of_birth	ukraine
charles_fane_2nd_viscount_fane	gender	male
rasmus_bartholin	place_of_birth	roskilde
cardinal_rodolfo_pio_da_carpi	place_of_birth	carpi
dixie_carter	institution	university_of_memphis
edward_c_walthall	place_of_birth	richmond_virginia
charles_dewey_day	place_of_death	england
wimalaratne_kumaragama	place_of_death	sri_lanka
ed_pulaski	nationality	united_states
james_jackson_1757	location	savannah
kamisese_mara	profession	politician
mathilde_franziska_anneke	place_of_birth	hattingen
walter_nathan_tobriner	location	washington_united_states
andre_franquin	profession	cartoonist
robert_p_robinson	religion	presbyterian_church_in_the_united_states_of_america
gerda_boyesen	place_of_death	london
wayne_macveagh	profession	diplomat
ian_carmichael	location	hull
raymond_unwin	gender	male
mike_mansfield	location	new_york
johann_casimir_duke_of_saxe_coburg	parents	johann_frederick_ii_duke_of_saxony
william_longchamp	religion	catholicism
maria_augusta_of_thurn_and_taxis	religion	roman_catholic_church
charles_mingus	gender	male
jim_gary	cause_of_death	cerebral_hemorrhage
carlo_di_palma	gender	male
george_gamow	profession	chemist
tommaso_buscetta	gender	male
cathy_berberian	place_of_death	rome
nikolai_anikin	cause_of_death	skiing
jean_alexandre_vaillant	gender	male
helga_haase	gender	female
armand_jean_du_plessis_cardinal_richelieu	profession	clergy
khalil_saeed_hawayek	gender	male
levi_lincoln_jr	location	worcester_massachusetts
franz_cardinal_ehrle	place_of_death	rome
moses_thatcher	religion	church_of_jesus_christ_of_latter-day_saints
william_extra_billy_smith	place_of_death	richmond_virginia
augusta_of_saxe-weimar	children	princess_louise_of_prussia
edward_lowe	gender	male
harold_godwinson	ethnicity	anglo-saxons
thomas_stewart_1940	gender	male
fritz_leiber_sr	place_of_birth	chicago
charles_blavette	gender	male
carl_williams	profession	laborer
roy_redgrave	gender	male
charles_porterfield_krauth	location	martinsburg
harriet_ann_jacobs	gender	female
eugene_charles_catalan	institution	university_of_paris
a_e_housman	profession	author
ian_copeland	gender	male
james_c_dobbin	place_of_death	fayetteville
paul_henri_benjamin_destournelles_de_constant	place_of_death	paris
moses_sheppard	profession	businessperson
william_of_blois	parents	matilda_of_boulogne
wilfred_grenfell	location	newfoundland_and_labrador
christopher_columbus	nationality	italy
emperor_huizong	nationality	china
edmund_knoll-kownacki	gender	male
alfonso_of_castile_prince_of_asturias	gender	male
pope_agapetus_ii	gender	male
hamar_alfred_bass	nationality	united_kingdom
thornton_wilder	nationality	united_states
franz_fuhmann	nationality	german_democratic_republic
kurt_fricke	place_of_birth	berlin
clodia	gender	female
justus_christian_loder	location	germany
dana_andrews	nationality	united_states
james_boswell	place_of_death	london
thomas_gold	location	vienna
walter_omalley	cause_of_death	cardiovascular_disease
milton_ernest_ricketts	institution	united_states_naval_academy
tamaz_nadareishvili	gender	male
hector_munro_macdonald	profession	mathematician
amenemhat_ii	children	senusret_ii
joey_bishop	location	newport_beach
robert_garrett	place_of_birth	baltimore_county
james_william_mcghee	nationality	united_states
nikolai_bukharin	place_of_death	moscow
humberto_fernandez_moran	institution	ludwig_maximilians_university_of_munich
william_w_crapo	place_of_death	new_bedford
daniel_waldo_1800	place_of_birth	harrison_county_west_virginia
henry_iv_of_england	children	henry_v_of_england
john_f_kennedy_jr	place_of_death	atlantic_ocean
reinard_maack	place_of_death	curitiba
max_jacob	nationality	france
grand_duke_cyril_vladimirovich_of_russia	gender	male
ephraim_carlebach	place_of_birth	lubeck
basil_lanneau_gildersleeve	nationality	united_states
pyotr_sergeyevich_novikov	institution	moscow_state_university
andreas_gottlob_rudelbach	place_of_death	slagelse
hermann_hoth	place_of_birth	neuruppin
robert_kidston	nationality	scotland
hubertus_von_bonin	place_of_birth	potsdam
frank_chance	profession	baseball_player
canaan_banana	cause_of_death	cancer
john_mayow	profession	chemist
agustin_munoz_grandes	gender	male
john_burnside_1916	profession	inventor
francis_biddle	place_of_birth	paris
angelique_du_coudray	gender	female
aatsista-mahkan	nationality	united_states
bjorn_helland_hansen	place_of_death	bergen
grace_kelly	institution	american_academy_of_dramatic_arts
margaret_truman	place_of_death	chicago
jeremias_benjamin_richter	place_of_death	berlin
james_naismith	ethnicity	scottish_canadian
robert_r_coats	profession	geologist
john_p_mccown	gender	male
ardeshir_irani	gender	male
james_joyce	religion	catholicism
john_dopyera	nationality	united_states
martin_luther_king_jr	profession	peace_activist
walter_reuther	nationality	united_states
christopher_robin_milne	location	dartmouth_united_kingdom
henry_kolker	location	quincy_illinois
george_herman_babcock	profession	engineer
xia_gui	profession	artist
pearl_bailey	spouse	louie_bellson
grand_duchess_elizabeth_mikhailovna	spouse	adolphe_grand_duke_of_luxembourg
louis_armand_i_prince_of_conti	place_of_death	fontainebleau
emil_holub	place_of_death	vienna
yosef_karo	place_of_birth	toledo_spain
joan_ii_of_naples	parents	charles_iii_of_naples
friedrich_wilhelm_von_steuben	gender	male
erich_kahler	place_of_birth	leipzig
eugen_dalbert	gender	male
edgard_varese	location	new_york
rodolphus_agricola	gender	male
john_hugh_mcnary	place_of_death	portland
marilyn_monroe	ethnicity	norwegian_american
ethel_merman	place_of_birth	astoria_oregon
dugald_c_jackson	location	united_states
nellie_quander	institution	new_york_university
pietro_pacciani	nationality	italy
anton_tomaz_linhart	gender	male
john_c_calhoun	profession	lawyer
charles_fairburn	place_of_birth	bradford
kavisekhara_dr_umar_alisha	religion	islam
george_h_prouty	nationality	united_states
dmitri_shepilov	profession	politician
gisselle_salandy	cause_of_death	car_accident
naseem_hijazi	profession	writer
paul_keres	location	narva
george_whiteman	gender	male
george_cadogan_5th_earl_cadogan	institution	christ_church_oxford
john_i_of_denmark	parents	dorothea_of_brandenburg
raymond_allen	nationality	united_states
martin_rodbell	location	united_states
fergal_ohanlon	cause_of_death	firearm
caspar_peucer	gender	male
levi_lincoln_jr	gender	male
theodore_g_bilbo	institution	university_of_michigan
william_morrow_east_maitland_new_south_wales	institution	newington_college
joel_r_p_pringle	institution	united_states_naval_academy
ferdinand_ii_of_the_two_sicilies	parents	maria_isabella_of_spain
takasugi_shinsaku	gender	male
ferdinand_maria_elector_of_bavaria	children	joseph_clemens_of_bavaria
richmond_pearson_hobson	place_of_birth	greensboro_alabama
chulalongkorn	children	sirabhorn_sobhon
emile_berliner	profession	inventor
thomas_allen_1813	institution	union_college
pavel_popovich	profession	aviator
hans_poelzig	profession	architect
frederick_william_i_of_prussia	children	frederick_ii_of_prussia
george_gabby_hayes	profession	actor
charles_lee_1758	location	alexandria_virginia
joanna_of_bourbon	gender	female
johann_friedrich_blumenbach	institution	friedrich_schiller_university_of_jena
richard_l_evans	nationality	united_states
henry_dreyfuss	place_of_death	south_pasadena
david_fumero	profession	actor
isidore_of_kiev	place_of_death	rome
george_b_martin	profession	judge
zinovy_peshkov	ethnicity	jew
henry_koster	nationality	united_states
william_nassau_de_zuylestein_4th_earl_of_rochford	profession	groom_of_the_stool
patience_wright	nationality	united_states
howard_ashman	place_of_death	new_york
kamehameha_v	gender	male
john_vi_of_portugal	gender	male
charles_mair	place_of_death	victoria_canada
barack_obama_sr	profession	economist
wallace_thurman	profession	publisher
john_schofield	gender	male
alvin_kraenzlein	place_of_death	wilkes_barre
j_reuben_clark	institution	columbia_university
milton_reckord	place_of_birth	harford_county
maria_klementyna_sobieska	gender	female
lawrence_pazder	nationality	canada
otto_brandenburg_1934	gender	male
turk_farrell	gender	male
carlo_ginori	gender	male
john_angelo_jackson	nationality	united_kingdom
adolphe_quetelet	nationality	belgium
alexander_j_dallas	gender	male
ferdinand_van_derveer	location	middletown_ohio
george_gallup	place_of_birth	iowa
henry_sandish	place_of_death	kenton_county
claus_luthe	place_of_death	munich
isabella_of_jerusalem	parents	amalric_i_of_jerusalem
emilio_salgari	place_of_birth	verona
dick_and_mac_mcdonald	ethnicity	white_american
dave_dudley	gender	male
martin_de_la_see	gender	male
milly_witkop	nationality	united_kingdom
edvard_fortunatus	gender	male
jean-louis_barrault	nationality	france
noble_sissle	location	indianapolis
isaac_babel	place_of_death	butyrka_prison
sheila_steele	gender	female
john_mair	place_of_birth	north_berwick
romualdo_pacheco	place_of_birth	santa_barbara
charles_scott	profession	politician
charles_lennox_richardson	nationality	united_kingdom
endicott_peabody	gender	male
george_thomas_montgomery	gender	male
wilhelm_reinhard_von_neipperg	place_of_death	vienna
joseph_m_juran	location	braila
richard_biggs	institution	university_of_southern_california
doug_ault	location	beaumont
rue_mcclanahan	nationality	united_states
juliette_peirce	spouse	charles_peirce
julian_trujillo_largacha	religion	roman_catholic_church
edward_joseph_lowe	profession	botanist
david_niven	profession	actor
miles_davis	place_of_birth	alton
james_d_howe	place_of_death	killed_in_action
frankie_vaughan	gender	male
percy_sutton	profession	politician
lovisa_of_sweden	children	haakon_vii_of_norway
charles_gore	institution	harrow_school
pope_alexander_ii	place_of_death	rome
albert_camus	profession	novelist
rahul_sankrityayan	profession	scientist
catherine_pavlovna_of_russia	gender	female
eisaku_sato	location	yamaguchi_prefecture
nicholas_yonge	nationality	england
martha_berry	gender	female
kirby_puckett	profession	baseball_player
william_north	nationality	united_states
james_noble_tyner	profession	lawyer
pietro_martire_vermigli	gender	male
feodor_i_of_russia	gender	male
franz_von_bayros	nationality	austria
edith_craig	parents	edward_william_godwin
john_mcdermott_1891	nationality	united_states
johan_gottschalk_wallerius	profession	geologist
c_l_moore	place_of_death	hollywood
walter_crane	profession	visual_artist
louis_iii_prince_of_conde	parents	henry_iii_jules_de_bourbon_prince_de_conde
a_f_lafir	place_of_birth	kandy
nicholas_gilman	gender	male
joshua_fisher	gender	male
ted_grant	place_of_birth	germiston_gauteng
raymond_deseze	place_of_birth	bordeaux
theodore_dreiser	location	terre_haute
john_h_overton	institution	louisiana_state_university
lyman_spitzer	institution	yale_university
anne_bannerman	location	edinburgh
emmanuel_marquis_de_grouchy	gender	male
john_maynard_smith	profession	scientist
christian_heinrich_friedrich_peters	nationality	germany
marin_sorescu	institution	university_of_iasi
rajadhiraja_chola	religion	hinduism
alice_austen	profession	photographer
christian_geist	place_of_birth	gustrow
philemon_wright	gender	male
emanuel_leutze	location	dusseldorf
anderson_ruffin_abbott	institution	oberlin_college
ludovico_cardinal_ludovisi	place_of_death	bologna
george_montagu	cause_of_death	infectious_disease
bo_hansson	profession	musician
julia_pastrana	place_of_birth	mexico
ohara_reiko	profession	actor
ernst_toch	gender	male
atle_selberg	nationality	united_states
benvenuto_cellini	religion	catholicism
herbert_nachbar	gender	male
amos_alonzo_stagg	institution	phillips_exeter_academy
lord_arthur_somerset	gender	male
john_winfield_wallace	place_of_death	new_castle_pennsylvania
donald_martino	gender	male
thomas_butler_king	gender	male
nathanael_ohridski	nationality	bulgaria
pedro_romero	place_of_death	spain
theodore_dreiser	place_of_death	hollywood
godert_de_ginkell_1st_earl_of_athlone	place_of_birth	utrecht
denman_thompson	profession	playwright
franz_konwitschny	profession	conducting
mendel_jackson_davis	profession	politician
andrew_w_k	profession	musician
franz_volkmar_reinhard	gender	male
myra_hindley	gender	female
john_e_davis	religion	lutheranism
fernando_martin_espina	gender	male
lonnie_johnson	profession	singer
william_ransom_johnson_pegram	place_of_death	dinwiddie_county
george_cabot	place_of_death	boston_massachusetts
antonio_montagnana	nationality	italy
margaret_theresa_of_spain	place_of_death	vienna
sancho_ii_of_castile	gender	male
inconnue_de_la_seine	nationality	france
dean_acheson	religion	episcopal_church_in_the_united_states_of_america
francis_leon	profession	drag_queen
juan_pedro_julian_aguirre_y_lopez_de_anaya	gender	male
hugo_vivian_hope_throssell	place_of_birth	northam
harry_hayden	place_of_death	west_los_angeles
david_zeisberger	nationality	united_states
david_meriwether_1800	place_of_death	louisville
joseph_mccarthy	gender	male
lord_buckley	profession	comedian
floyd_gibbons	gender	male
jacob_burnet	gender	male
linus_pauling	location	united_states
earl_hurd	profession	animator
oscar_peterson	gender	male
naji_al-ali	cause_of_death	firearm
eddy_duchin	gender	male
irene	spouse	leo_iv_the_khazar
elena_vacarescu	place_of_birth	bucharest
odon_lechner	place_of_death	budapest
bruce_ariss	gender	male
thomas_hopkins_gallaudet	religion	christianity
hoyt_vandenberg	institution	united_states_military_academy
patsy_kelly	place_of_death	woodland_hills
pieter_lastman	gender	male
johann_maier	place_of_death	regensburg
fra_diamante	religion	catholicism
isabel_irving	gender	female
richard_tangye	profession	engineer
alexander_borodin	gender	male
paul_henreid	nationality	austria
alexander_luders	gender	male
conrad_busken-huet	place_of_death	paris
alessandro_allori	location	florence
edward_cardinal_mooney	location	youngstown
maurice_durufle	gender	male
jorg_von_halsbach	nationality	germany
francis_perceval_eliot	gender	male
tomaz_humar	place_of_birth	ljubljana
erik_erikson	profession	scientist
waldo_p_johnson	profession	lawyer
george_croly	gender	male
alfred_lebbeus_loomis	location	new_york
noble_sissle	place_of_birth	indianapolis
allen_jenkins	nationality	united_states
louis_i_count_of_blois	gender	male
sue_gunter	nationality	united_states
dick_taverne_baron_taverne	institution	charterhouse_school
robert_mcclelland	place_of_birth	greencastle_pennsylvania
yukichi_chuganji	nationality	japan
chojun_miyagi	gender	male
franco_alfano	profession	pianist
abraham_ortelius	place_of_birth	antwerp
michael_rua	gender	male
henry_herbert_4th_earl_of_carnarvon	nationality	united_kingdom
lilyan_chauvin	place_of_birth	paris
peter_f_rothermel	location	pennsylvania
p_v_narasimha_rao	cause_of_death	myocardial_infarction
henri_louis_le_chatelier	institution	ecole_polytechnique
henry_ward_poole	profession	inventor
ernst_frederick_duke_of_saxe_coburg_saalfeld	nationality	germany
james_b_howell	place_of_birth	morristown
frederick_funston	place_of_death	san_antonio
william_adams_1564	nationality	united_kingdom
florence_l_barclay	profession	novelist
evelyn_brent	profession	actor
thomas_digges	parents	leonard_digges
marten_triewald	gender	male
heinrich_christian_burckhardt	place_of_death	hanover
cyril_vosper	cause_of_death	myocardial_infarction
pridi_phanomyong	place_of_death	paris
hamdollah_mostowfi	place_of_birth	qazvin
simone_mareuil	place_of_birth	perigueux
meir_shapiro	place_of_death	lublin
aad_mansveld	place_of_birth	the_hague
empress_matilda	spouse	henry_v_holy_roman_emperor
mateus_fernandes	profession	architect
alfred_rosenberg	profession	writer
alfred_thibaudeau	gender	male
bartholomeus_van_der_helst	place_of_birth	haarlem
j_james_exon	institution	university_of_nebraska_at_omaha
vincent_price	cause_of_death	lung_cancer
james_henry_hackett	children	james_keteltas_hackett
luis_cardoza_y_aragon	profession	diplomat
matthias_sindelar	place_of_death	vienna
john_p_jones	gender	male
ichabod_washburn	gender	male
chuck_schuldiner	gender	male
rinaldo_deste	place_of_death	modena
benjamin_britten	institution	greshams_school
nikolay_strunnikov	gender	male
marguerite_of_france	parents	maria_of_brabant
shoghi_effendi	place_of_birth	acre_israel
alistair_cooke	cause_of_death	lung_cancer
carl_anderson	profession	actor
francis_manners_6th_earl_of_rutland	profession	nobleman
ilya_golosov	place_of_birth	moscow
lazarus_w_powell	nationality	united_states
florence_roberts	nationality	united_states
mae_west	spouse	guido_deiro
pentti_airikkala	profession	racecar_driver
lucius_d_battle	institution	university_of_florida
harold_fisher	profession	mayor
john_mcgovern_1825	gender	male
max_schmeling	profession	professional_boxer
john_pratt_1st_marquess_camden	institution	trinity_college_cambridge
william_h_c_whiting	institution	georgetown_university
samuel_dickinson_hubbard	profession	manufacturer
alphonse_halimi	religion	judaism
f_a_voigt	place_of_birth	hampstead
barthelemy_dherbelot_de_molainville	gender	male
gijsbert_karel_van_hogendorp	place_of_birth	rotterdam
karl_marx	location	trier
glenna_collett-vare	nationality	united_states
john_galbraith	location	erie
pedro_nel_ospina	gender	male
ludvik_askenazy	profession	writer
kurt_lewin	ethnicity	jew
hassan_fathy	profession	architect
james_hepburn_campbell	nationality	united_states
b_j_young	location	anchorage
emil_orlik	place_of_death	berlin
wheeler_oakman	profession	actor
francis_dickens	gender	male
kamran_mirza_nayeb_es_saltaneh	place_of_death	tehran
charles_joseph_alleyn	location	quebec_city
marc_rene_marquis_de_montalembert	place_of_birth	angouleme
haj_ali_razmara	cause_of_death	firearm
s_n_behrman	nationality	united_states
hermann_loew	nationality	germany
dipa_nusantara_aidit	nationality	indonesia
kim_kwang_suk	cause_of_death	suicide
theodore_e_burton	gender	male
benedikt_livshits	gender	male
terry_knight	profession	talent_manager
percy_kilbride	place_of_death	los_angeles
frank_j_lausche	nationality	united_states
vano_muradeli	place_of_birth	gori
jacob_collamer	institution	university_of_vermont
johnny_haynes	place_of_death	edinburgh
frank_hinkey	institution	yale_university
john_c_caldwell	profession	diplomat
felix_moncla	gender	male
jon_latimer	profession	writer
robert_stanfield	religion	anglicanism
jack_owens	gender	male
john_hubert_hall	institution	oregon_state_university
pinky_lee	nationality	united_states
john_monger	gender	male
neofit_rilski	profession	writer
george_jessel	spouse	lois_andrews
stanley_kubrick	location	the_bronx
mihailo_petrovic	institution	university_of_belgrade
tom_wilson	location	waco
james_louis_odonel	gender	male
albert_eulenburg	gender	male
james_cameron_1914	nationality	united_states
matthaus_lang_von_wellenburg	place_of_death	salzburg
rashid_behbudov	gender	male
rufus_payne	profession	musician
john_maynard_keynes	nationality	united_kingdom
luis_carrera	nationality	chile
conrad_gessner	cause_of_death	bubonic_plague
babatunji_olowofoyeku	ethnicity	yoruba
mori_motonari	location	aki_province
ryan_larkin	nationality	canada
eddie_gray_gardena	profession	racecar_driver
michel_corneille_the_elder	place_of_birth	paris
julius_vogel	place_of_death	london
albert_ii_of_germany	children	anne_duchess_of_luxembourg
suleiman_mousa	nationality	jordan
hans_heinrich_dieckhoff	profession	diplomat
william_g_zuern_jr	place_of_birth	ohio
tony_snow	location	kentucky
robert_doisneau	nationality	france
matthew_robinson_1912	place_of_death	pasadena
roy_andries_de_groot	nationality	united_states
sergei_prokofiev	profession	conducting
ellis_bent	profession	barrister
johanna_gadski	nationality	germany
patrick_dewaere	profession	actor
oliver_belmont	gender	male
lucien_guitry	gender	male
costas_montis	place_of_birth	famagusta
anthony_baldinucci	gender	male
la_lupe	nationality	united_states
mohammed_murtuza_siddiqui	place_of_birth	hyderabad_state
karl_freiherr_von_hasenauer	location	vienna
william_golding	nationality	england
khalil_gibran	cause_of_death	tuberculosis
hermann_rauschning	profession	politician
rufus_choate	religion	christian
william_christopher_macdonald	gender	male
james_whale	place_of_birth	dudley
richard_mccoy_jr	place_of_death	virginia_beach
william_pickering	place_of_death	illinois
guo_moruo	location	sichuan
caesar_van_everdingen	nationality	netherlands
arthur_nikisch	profession	conducting
barry_winchell	place_of_birth	kansas_city
joao_de_deus	nationality	portugal
margaret_morse_nice	nationality	united_states
emperor_shomu	place_of_death	nara
simeon_of_jerusalem	place_of_birth	galilee
uriel_jones	ethnicity	african_american
william_porcher_miles	nationality	united_states
freddie_mercury	profession	singer-songwriter
bob_montana	gender	male
benjamin_thompson	nationality	germany
jean_lescure	profession	physician
wilhelm_marr	nationality	germany
anton_bernolak	ethnicity	slovaks
george_a_frederick	gender	male
marlon_brando	location	omaha_nebraska
susan_b_anthony	place_of_death	rochester
hugh_ike_shott	gender	male
john_j_williams	profession	businessperson
william_napier	gender	male
augustus_ii_the_strong	religion	catholicism
paul_gallico	profession	novelist
andreas_gryphius	gender	male
alfred_ely_beach	place_of_death	new_york
andres_hurtado_de_mendoza	nationality	spain
johnnie_taylor	profession	singer
jacob_schiff	nationality	germany
avraham_stern	gender	male
alexander_meiklejohn	nationality	united_states
john_denny_1846	gender	male
frederic_t_greenhalge	nationality	united_states
irwin_allen	place_of_death	santa_monica_california
khai_dinh	gender	male
giovanni_pierluigi_da_palestrina	place_of_death	rome
john_cage	place_of_birth	los_angeles
pedro_pablo_abarca_de_bolea_count_of_aranda	nationality	spain
ion_i_c_bratianu	cause_of_death	infectious_disease
frank_gilbreth_jr	location	montclair
john_jacob_rhodes	institution	kansas_state_university
grant_williams_1930	profession	actor
sava_tekelija	location	arad
jean-baptiste_morin	profession	mathematician
lise_meitner	place_of_death	cambridge
thomas_plantagenet_2nd_earl_of_lancaster	gender	male
michael_crescenz	place_of_birth	philadelphia
louis_7th_duc_de_broglie	place_of_birth	dieppe_seine_maritime
frederic_william_maitland	place_of_birth	london
gerald_mohr	location	new_york
johann_david_passavant	place_of_death	frankfurt
bill_finger	place_of_death	new_york_county
george_eugene_uhlenbeck	ethnicity	dutch_people
alice_joyce	spouse	clarence_brown
john_of_procida	place_of_birth	salerno
lars_onsager	institution	yale_university
jaime_cardinal_sin	gender	male
shukri_al-kuwatli	place_of_death	beirut
helen_walton	place_of_death	bentonville
maximilian_frederick_of_konigsegg_rothenfels	gender	male
john_d_hoblitzell_jr	place_of_death	clarksburg
cyril_rootham	nationality	england
james_m_comly	place_of_death	toledo_ohio
francisco_manuel_trigoso	profession	politician
virginia_woolf	cause_of_death	drowning
gustav_ludwig_hertz	profession	physicist
homer_croy	profession	writer
susie_cooper	nationality	united_kingdom
mae_west	cause_of_death	stroke
paul_masson_1874	profession	professional_road_racing_cyclist
norwood_russell_hanson	nationality	united_states
johannes_verhulst	place_of_birth	the_hague
eleftherios_venizelos	gender	male
john_gordon_sprigg	gender	male
jimmy_mcculloch	place_of_birth	glasgow
therese_johanne_alexandra_tietjens	profession	singer
frans_van_schooten	profession	mathematician
elmer_hewitt_capen	institution	tufts_university
robert_grimm	profession	politician
petter_stenborg	gender	male
samuel_scherschewsky	religion	anglicanism
luis_marquina	location	madrid
samuel_of_waldebba	place_of_birth	ethiopia
ernst_von_wolzogen	nationality	germany
louise_de_la_valliere	location	tours
john_entwistle	gender	male
abraham_vater	place_of_birth	wittenberg
gustav_machaty	profession	screenwriter
lady_elizabeth_stanley	spouse	henry_hastings_5th_earl_of_huntingdon
franz_josef_strauss	place_of_birth	munich
charles_angrand	nationality	france
george_bernard_shaw	profession	playwright
joseph_aiuppa	nationality	united_states
hermann_minkowski	profession	mathematician
george_croghan_1791	nationality	united_states
beals_wright	gender	male
warring_kennedy	gender	male
jackson_c_pharris	nationality	united_states
halford_john_mackinder	institution	christ_church_oxford
tony_snow	cause_of_death	cancer
ernst_lecher	gender	male
antoine_barnave	cause_of_death	guillotine
jack_warden	place_of_birth	newark
charles_jackson_paine	nationality	united_states
big_moe	ethnicity	african_american
bhagat_singh	place_of_death	lahore
aurelian	place_of_birth	sirmium
frank_w_benson	location	california
thomas_cleeve	place_of_death	limerick
tyrone_power	profession	actor
kitiyakara_voralaksana	children	nakkhatra_mangkala_kitiyakara
edie_sedgwick	place_of_birth	santa_barbara
hermann_heller	place_of_death	madrid
richard_e_gray	nationality	united_states
arthur_joseph_davis	nationality	united_kingdom
john_ambrose_fleming	place_of_birth	lancaster
giorgos_seferis	profession	diplomat
jeffry_wyattville	gender	male
martin_van_marum	place_of_birth	delft
larry_norman	location	salem_oregon
rigobert_bonne	gender	male
robert_creeley	profession	writer
fyodor_dostoevsky	gender	male
christoph_von_schmid	place_of_death	augsburg
jim_backus	location	cleveland_ohio
diana_lynn	gender	female
william_brockman	nationality	united_states
jose_sebastiao_cardinal_dalmeida_neto	place_of_death	seville
stanislas_lepine	place_of_birth	caen
carlos_chavez	place_of_birth	mexican_federal_district
tudor_jenks	institution	yale_university
john_simpson_knox	location	glasgow
david_janssen	place_of_death	malibu
shusha_guppy	profession	singer
charles_farrar_browne	gender	male
guillermo_meneses	location	caracas
adelheid_i_abbess_of_quedlinburg	place_of_death	quedlinburg_abbey
franz_xaver_wolfgang_mozart	parents	constanze_mozart
eduard_bernstein	profession	politician
ole_olsen_1892	gender	male
charles_alston	institution	columbia_university
minerva_j_chapman	place_of_death	palo_alto
steve_hislop	gender	male
barbu_catargiu	cause_of_death	firearm
henry_martyn	location	kanpur
james_merrill	place_of_death	arizona
d_z_phillips	gender	male
mack_swain	location	salt_lake_city
bezmialem	children	abdulmecid
bruce_cabot	place_of_birth	carlsbad
dana_elcar	nationality	united_states
peter_altenberg	ethnicity	jew
cynthia_may_alden	location	indiana
james_joseph_hayes_doone	profession	politician
william_watson_1715	place_of_death	london
guido_tarlati	place_of_birth	arezzo
elias_nelson_conway	location	arkansas
paul_de_smet_de_naeyer	place_of_birth	ghent
francois_mitterrand	place_of_death	paris
richard_cox_1500	institution	kings_college_cambridge
lou_boudreau	location	harvey_illinois
anne_morgan	gender	female
thomas_mayne_daly	profession	lawyer
william_fox_1812	religion	anglicanism
f_k_waechter	place_of_birth	gdansk
daniel_massey_1933	institution	kings_college_cambridge
theophilos	gender	male
francis_patrick_baker	profession	politician
rodolfo_kuhn	profession	film_producer
farial_of_egypt	cause_of_death	stomach_cancer
roland_west	location	cleveland_ohio
guillaume_delisle	gender	male
abdullah_yusuf_azzam	place_of_death	peshawar
william_wrigley_jr	profession	businessperson
alfred_boultbee	gender	male
decius	spouse	herennia_etruscilla
evalyn_knapp	nationality	united_states
joseph_santley	location	utah
aaron_harding	profession	politician
pierre_felix_masseau	place_of_birth	lyon
eva_norvind	profession	journalist
henry_scott_3rd_duke_of_buccleuch	institution	eton_college
nathaniel_bliss	religion	anglicanism
catherine_de_medici	parents	madeleine_de_la_tour_dauvergne
sholem_asch	profession	writer
lettice_knollys	nationality	kingdom_of_england
katherine_routledge	gender	female
phillip_rastelli	nationality	united_states
julius_fucik	location	prague
henry_gantt	gender	male
noah_haynes_swayne	profession	lawyer
charlie_barnet	gender	male
peter_kolosimo	nationality	italy
jan_de_quay	nationality	netherlands
gheorghe_tatarescu	religion	romanian_orthodox_church
vyacheslav_molotov	nationality	soviet_union
martha_hughes_cannon	nationality	united_states
mary_i_of_scotland	spouse	francis_ii_of_france
james_w_cooke	location	north_carolina
tom_ohorgan	profession	theatre_direction
theodor_von_sickel	nationality	germany
isidore_of_seville	profession	philosopher
dewitt_clinton	place_of_death	albany
pedro_antonio_de_alarcon	gender	male
penelope_blount_countess_of_devonshire	parents	walter_devereux_1st_earl_of_essex
taylor_caldwell	profession	novelist
jules_simon	gender	male
francis_evanturel	nationality	canada
martin_razus	nationality	slovakia
harlan_page_beach	place_of_birth	south_orange
virginia_obrien	spouse	kirk_alyn
william_trumbull	gender	male
valentin_paniagua	institution	national_university_of_san_marcos
albert_i_prince_of_thurn_and_taxis	place_of_death	regensburg
freddie_perren	profession	musician
nils_ericson	profession	engineer
woody_stephens	profession	horse_trainer
josias_simmler	nationality	switzerland
richard_l_t_beale	institution	university_of_virginia
david_bodian	place_of_birth	st_louis_missouri
joseph_merrick	place_of_birth	leicester
john_burroughs	religion	pantheism
nancy_daus	location	boston_massachusetts
jorge_holguin	place_of_death	bogota
charles_cutler	religion	anglicanism
luis_a_ferre	religion	roman_catholic_church
alice_hegan_rice	profession	writer
eben_william_robertson	gender	male
tom_conway	nationality	united_kingdom
inagaki_manjiro	institution	university_of_tokyo
james_iv_of_scotland	ethnicity	scottish_people
juan_pujol	place_of_birth	barcelona
lee_patrick	profession	actor
dnyaneshwar	profession	writer
ricardo_cortez	gender	male
ben_hogan	gender	male
ibn_al-haitham	location	basra
iosif_kheifits	profession	film_director
theda_bara	profession	actor
lyle_r_wheeler	gender	male
monty_banks	nationality	italy
paul_schultze-naumburg	location	naumburg
abe_lemons	nationality	united_states
martin_wickramasinghe	ethnicity	sinhalese_people
james_stanley_10th_earl_of_derby	nationality	kingdom_of_england
hugh_talbot_burgoyne	place_of_birth	dublin
richard_bentley	institution	wadham_college_oxford
levin_schucking	gender	male
alfred_rosenberg	profession	architect
john_r_lynch	place_of_death	chicago
harry_hylton-foster	institution	eton_college
william_b_rosson	place_of_birth	iowa
jim_thurman	institution	university_of_michigan
angel_sauce	location	caracas
henri_harpignies	gender	male
f_s_norcross	place_of_birth	menominee_michigan
georg_petel	nationality	germany
bill_wambsganss	location	cleveland_ohio
john_lesley	nationality	scotland
johnny_beauchamp	profession	racecar_driver
frank_rockefeller	gender	male
gabriel_garcia_moreno	religion	roman_catholic_church
ernst_forstemann	nationality	germany
richard_bright_1937	place_of_birth	brooklyn
geoffrey_toone	place_of_birth	dublin
blaster_bates	cause_of_death	diabetes_mellitus
mieczyslaw_cardinal_ledochowski	place_of_death	rome
arthur_steere	location	rhode_island
hartmann_schedel	place_of_birth	nuremberg
waldo_waterman	gender	male
andrea_naccari	institution	university_of_padua
robin_moore	gender	male
nikki_sudden	location	berlin
kapiolani	gender	female
frederick_henry_johnson	profession	engineer
barnard_elliott_bee_jr	place_of_birth	charleston
charles_radbourn	gender	male
richard_k_sutherland	gender	male
eleuthere_irenee_du_pont	gender	male
archibald_cox	profession	lawyer
luca_della_robbia	gender	male
subba_row	gender	male
edward_eggleston	gender	male
kofi_abrefa_busia	profession	politician
gustav_iv_adolf_of_sweden	place_of_birth	stockholm_palace
richard_rood	nationality	united_states
jean-baptiste_louis_gros	gender	male
indrani_rahman	place_of_death	new_york_state
mehmed_vi	parents	abdulmecid
joseph_conrad	religion	atheism
william_martin_cafe	location	london
paul_lazarsfeld	religion	judaism
lawanda_page	place_of_death	hollywood
thomas_blamey	place_of_birth	wagga_wagga
betty_carter	place_of_birth	flint_michigan
henry_iii_of_france	parents	catherine_de_medici
jose_guilherme_merquior	nationality	brazil
fernand_holweck	gender	male
leo_carrillo	profession	actor
enric_miralles	nationality	spain
horace_hood	place_of_birth	london
jonathan_eybeschutz	gender	male
john_jacob_rogers	place_of_birth	lowell
nikolai_chernyshevsky	place_of_birth	saratov
gaudenzio_ferrari	profession	artist
john_le_mesurier	profession	actor
marguerite_courtot	place_of_death	long_beach
mary_mcleod_bethune	location	florida
athelstan_spilhaus	place_of_birth	cape_town
sir_ralph_freeman	profession	civil_engineer
janis_carter	place_of_death	durham_north_carolina
richard_tucker	place_of_death	kalamazoo_michigan
joseph_d_taylor	institution	university_of_cincinnati_college_of_law
jockey_shabalala	profession	singer
jacques_goddet	place_of_birth	paris
frederic_chopin	ethnicity	poles
mance_lipscomb	profession	musician
h_h_lewis	gender	male
frank_j_battisti	institution	ohio_state_university
cymburgis_of_masovia	nationality	austria
stanislaw_bareja	place_of_death	essen
alexander_mcneill	gender	male
theresa_merritt	ethnicity	african_american
john_mills	profession	actor
eusebe_renaudot	place_of_birth	paris
robert_todd_williams	cause_of_death	heart_disease
martha_griffiths	institution	university_of_michigan
peter_bohler	profession	bishop
alexandra_fyodorovna_of_hesse	cause_of_death	murder
bernard_bresslaw	nationality	england
hussein_onn	gender	male
john_francis_dodge	place_of_death	new_york
robert_l_bacon	location	boston_massachusetts
princess_tia	parents	seti_i
samuel_worcester	gender	male
david_howard_hitchcock	location	hilo
alexandre_angelique_de_talleyrand_perigord	profession	politician
john_mcclelland_1810	place_of_death	widnes
james_holman	place_of_death	london
george_welch	profession	test_pilot
paul_francis_webster	institution	cornell_university
tammy_wynette	location	mississippi
joe_serna_jr	profession	professor
moses_coit_tyler	gender	male
richard_seddon	religion	anglicanism
nils_slaatto	place_of_birth	lillehammer
tengiz_abuladze	place_of_birth	kutaisi
theodor_mundt	place_of_death	berlin
william_phips	gender	male
salvador_reyes_figueroa	place_of_death	santiago_chile
samira_bellil	religion	islam
stefan_bogoridi	place_of_birth	kotel
june_pointer	nationality	united_states
lester_cuneo	nationality	united_states
giovanni_bottesini	gender	male
jerzy_andrzejewski	gender	male
john_v_palaiologos	children	manuel_ii_palaiologos
johann_peter_krafft	nationality	germany
kenneth_rexroth	location	california
christine_chubbuck	place_of_death	sarasota
paul_painleve	nationality	france
gojko_susak	profession	politician
mitchell_sharp	place_of_birth	winnipeg
ignaz_goldziher	profession	scientist
frank_coe	nationality	united_states